{
    "rooms": {
        "room_01": {
            "layout": [
                "WWWWWWWWWWWWWWWWWWWWWWWWWWWWWW",
                "W............................W",
                "W............................W",
                "W......WWWW........WWWW......W",
                "W......WWWW........WWWW......W",
                "W......WWWW........WWWW......W",
                "W............................W",
                "W............................W",
                "W............................W",
                "W............................W",
                "W............................W",
                "W......WWWW........WWWW......W",
                "W......WWWW........WWWW......W",
                "W......WWWW........WWWW......W",
                "W............................W",
                "W............................W",
                "WWWWWWWWWWWWWWWWWWWWWWWWWWWWWW"
            ],
            "enemy_spawns": [[2, 14]]
        },
        "room_02": {
            "layout": [
                "WWWWWWWWWWWWWWWWWWWWWWWWWWWWWW",
                "W............................W",
                "W............................W",
                "W............................W",
                "WWWWWWWWWWWWWWWWWWWWWWWWW....W",
                "W............................W",
                "W............................W",
                "W............................W",
                "W............................W",
                "W............................W",
                "W............................W",
                "W............................W",
                "W....WWWWWWWWWWWWWWWWWWWWWWWWW",
                "W............................W",
                "W............................W",
                "W............................W",
                "WWWWWWWWWWWWWWWWWWWWWWWWWWWWWW"
            ],
            "enemy_spawns": [[2, 14], [27, 2]]
        },
        "room_03": {
            "layout": [
                "WWWWWWWWWWWWWWWWWWWWWWWWWWWWWW",
                "W............................W",
                "W..WWWWWW..WWWW....WWWWWW..W.W",
                "W..W....W.....W....W....W..W.W",
                "W..W.W..W..W..W....W.W..W..W.W",
                "W....W.....W............W....W",
                "WWWWWW..WWWWWWWWWWWW..WWWWWWWW",
                "W............................W",
                "W....WWWWWW........WWWWWW....W",
                "W....W....W........W....W....W",
                "WWWWWW....W..WWWW..W....WWWWWW",
                "W............W..W............W",
                "W..W.W.W.W...W..W...W.W.W.W..W",
                "W..W.W.W.W...WWWW...W.W.W.W..W",
                "W............................W",
                "W............................W",
                "WWWWWWWWWWWWWWWWWWWWWWWWWWWWWW"
            ],
            "enemy_spawns": [[14, 7], [3, 14], [25, 14]]
        }
    }
}